---
name: "Trap one"
width: 9
height: 9
tilemap: |
  2, 1, 1, 1, 1, 1, 1, 1, 2
  1, 0, 0, 0, 0, 0, 0, 0, 1
  1, 0, 0, 0, 0, 0, 0, 0, 1
  1, 0, 0, 0, 0, 0, 0, 0, 1
  1, 0, 9, 0, 0, 0, 7, 0, 1
  1, 0, 0, 0, 0, 0, 0, 0, 1
  1, 0, 0, 0, 0, 0, 0, 0, 1
  1, 0, 0, 0, 0, 0, 0, 0, 1
  2, 1, 1, 1, 1, 1, 1, 1, 2