---
name: "Oh no!"
width: 15
height: 13
tilemap: |
  0, 0, 0, 0, 0, 2, 0, 0, 0, 2, 0, 0, 0, 0, 0
  0, 0, 0, 0, 0, 2, 0, 0, 0, 2, 0, 0, 0, 0, 0
  0, 0, 0, 0, 0, 2, 0, 0, 0, 2, 0, 0, 8, 0, 0
  0, 0, 0, 0, 0, 2, 0, 0, 0, 2, 0, 0, 0, 0, 0
  0, 0, 0, 0, 0, 2, 0, 0, 0, 2, 0, 0, 0, 0, 0
  0, 0, 0, 0, 0, 2, 2, 2, 2, 2, 0, 0, 0, 0, 0
  0, 0, 9, 0, 0, 5, 0, 0, 6, 5, 0, 0, 0, 7, 0
  0, 0, 0, 0, 0, 2, 2, 2, 2, 2, 0, 0, 0, 0, 0
  0, 0, 0, 0, 0, 2, 0, 0, 0, 2, 0, 0, 0, 0, 0
  0, 0, 0, 0, 0, 2, 0, 0, 0, 2, 0, 0, 0, 0, 0
  0, 0, 0, 0, 0, 2, 0, 0, 0, 2, 0, 0, 8, 0, 0
  0, 0, 0, 0, 0, 2, 0, 0, 0, 2, 0, 0, 0, 0, 0
  0, 0, 0, 0, 0, 1, 0, 0, 0, 6, 0, 0, 0, 0, 0
objects:
  - kind: crate
    x: 9
    z: 12