---
name: "Where are my boxes?"
width: 16
height: 16
score_perfect: 164
score_okay: 153
tilemap: |
  0, 0, 0, 2, 2, 2, 2, 0, 0, 0, 0, 0, 2, 0, 0, 0
  0, 0, 0, 2, 0, 0, 0, 2, 0, 0, 0, 0, 2, 0, 0, 0
  0, 0, 0, 2, 0, 0, 8, 2, 0, 0, 0, 0, 2, 0, 0, 0
  0, 0, 0, 1, 0, 8, 0, 2, 0, 0, 0, 0, 2, 0, 0, 0
  0, 0, 0, 2, 0, 0, 0, 2, 0, 0, 0, 0, 2, 1, 0, 0
  0, 0, 0, 0, 2, 2, 2, 0, 0, 0, 0, 0, 2, 0, 0, 1
  0, 0, 0, 0, 0, 0, 0, 0, 0, 0, 0, 0, 2, 0, 0, 0
  0, 0, 0, 0, 0, 0, 0, 0, 0, 0, 0, 6, 2, 0, 0, 0
  0, 0, 0, 0, 0, 0, 5, 5, 5, 0, 0, 0, 2, 0, 0, 0
  0, 0, 0, 0, 0, 0, 0, 0, 0, 5, 0, 0, 2, 0, 1, 1
  0, 0, 0, 0, 0, 0, 0, 0, 0, 5, 0, 0, 2, 0, 0, 0
  0, 0, 0, 0, 0, 2, 0, 0, 0, 5, 0, 0, 2, 0, 0, 0
  0, 0, 0, 0, 0, 2, 0, 0, 7, 5, 0, 0, 2, 1, 0, 0
  0, 0, 9, 0, 0, 0, 5, 5, 5, 0, 0, 0, 2, 0, 0, 0
  0, 0, 0, 0, 0, 0, 0, 0, 0, 0, 0, 0, 2, 0, 0, 0
  0, 0, 0, 0, 0, 0, 0, 0, 0, 0, 0, 0, 2, 0, 1, 0
objects:
  - kind: crate
    x: 11
    z: 7