---
name: "Pick your side"
width: 17
height: 11
score_perfect: 89
score_okay: 87
tilemap: |
  0, 0, 0, 0, 0, 0, 0, 0, 5, 0, 0, 0, 0, 0, 0, 0, 0
  0, 0, 0, 0, 0, 0, 0, 0, 6, 0, 0, 0, 0, 0, 0, 0, 0
  0, 0, 0, 0, 7, 0, 0, 0, 5, 0, 0, 0, 8, 0, 0, 0, 0
  0, 0, 0, 0, 0, 0, 0, 0, 5, 0, 0, 0, 0, 0, 0, 0, 0
  0, 0, 0, 0, 0, 0, 0, 0, 5, 0, 0, 0, 0, 0, 0, 0, 0
  0, 9, 1, 0, 0, 0, 0, 0, 2, 0, 0, 0, 0, 0, 1,11, 0
  0, 0, 0, 0, 0, 0, 0, 0, 5, 0, 0, 0, 0, 0, 0, 0, 0
  0, 0, 0, 0, 0, 0, 0, 0, 5, 0, 0, 0, 0, 0, 0, 0, 0
  0, 0, 0, 0, 8, 0, 0, 0, 5, 0, 0, 0, 7, 0, 0, 0, 0
  0, 0, 0, 0, 0, 0, 0, 0, 6, 0, 0, 0, 0, 0, 0, 0, 0
  0, 0, 0, 0, 0, 0, 0, 0, 5, 0, 0, 0, 0, 0, 0, 0, 0