---
name: "Hostages"
width: 16
height: 18
score_perfect: 244
score_okay: 200
tilemap: |
  0, 0, 0, 0, 0, 0, 0, 0, 8, 0, 0, 0, 0, 0, 0, 0
  0, 0, 0, 0, 0, 2, 2, 2, 5, 2, 2, 0, 0, 0, 0, 0
  0, 0, 0, 0, 0, 2, 0,11, 0,11, 2, 0, 0, 2, 2, 2
  2, 5, 2, 0, 0, 2,11, 0,11, 0, 2, 0, 0, 2, 6, 1
  2, 6, 2, 0, 0, 2, 2, 2, 2, 2, 2, 0, 0, 2, 2, 1
  2, 8, 2, 0, 0, 0, 0, 0, 0, 0, 0, 0, 0, 0, 0, 0
  2, 1, 2, 0, 0, 0, 0, 0, 0, 0, 0, 0, 0, 0, 0, 0
  0, 0, 0, 0, 0, 0, 0, 0, 0, 0, 0, 8, 0, 0, 0, 0
  0, 0, 0, 0, 0, 0, 0, 0, 0, 0, 0, 0, 0, 0, 0, 0
  0, 8, 0, 1, 1, 2, 0, 0, 0, 0, 0, 0, 0, 0, 0, 0
  0, 0, 0, 0, 0, 0, 0, 0, 0, 0, 0, 0, 0, 0, 0, 0
  0, 0, 0, 0, 0, 0, 0, 0, 0, 1, 0, 0, 0, 0, 0, 0
  0, 0, 7, 0, 0, 0, 0, 0, 0, 1, 0, 0, 0, 0, 0, 0
  0, 0, 0, 0, 0, 2, 2, 0, 0, 0, 0, 0, 0, 0, 0, 0
  0, 0, 0, 0, 0, 0, 0, 0, 0, 0, 0, 0, 0, 0, 0, 0
  0, 0, 0, 0, 0, 0, 0, 0, 0, 0, 0, 0, 0, 0, 0, 0
  0, 0, 0, 0, 0, 0, 0, 9, 0, 0, 0, 0, 0, 0, 0, 0
  0, 0, 0, 0, 0, 0, 0, 0, 0, 0, 0, 0, 0, 0, 0, 0
objects:
  - kind: crate
    x: 1
    z: 4
  - kind: crate
    x: 14
    z: 3