---
name: "Dual freeze"
width: 11
height: 11
tilemap: |
  0, 0, 0, 0, 0, 0, 0, 0, 0, 0, 0
  0, 8, 0, 0, 0, 0, 0, 0, 0, 0, 0
  0, 0, 0, 2, 2, 2, 0, 2, 0, 2, 0
  0, 2, 0, 0, 0, 2,10, 2, 0, 2, 0
  0, 2, 0, 2, 0, 2, 0, 2, 0, 2, 0
  0, 2, 2, 2, 0, 2, 0, 2, 2, 2, 0
  0, 0, 0, 2, 0, 2, 0, 2, 0, 0, 0
  0, 0, 0, 2,10, 0, 0, 0, 0, 0, 0
  0, 0, 0, 2, 2, 2, 2, 2, 0, 0, 0
  0, 9, 0, 0, 0, 0, 0, 0, 0, 0, 8
  0, 0, 0, 0, 0, 0, 0, 0, 0, 0, 0
