---
name: "Bag"
width: 11
height: 11
tilemap: |
  0, 0, 0, 0, 0, 0, 0, 0, 0, 0, 0
  0, 0, 0, 0, 0, 0, 0, 0, 0, 0, 0
  0, 0, 0, 0, 0, 0, 0, 0, 0, 0, 0
  0, 2, 0, 0, 2, 0, 0, 2, 0, 0, 0
  0, 2, 2, 2, 2, 2, 2, 2, 0, 0, 0
  0, 2,10, 1, 9, 0, 0, 0, 0, 7, 0
  0, 2, 2, 2, 2, 2, 2, 2, 0, 0, 0
  0, 2, 0, 0, 2, 0, 0, 2, 0, 0, 0
  0, 0, 0, 0, 0, 0, 0, 0, 0, 0, 0
  0, 0, 0, 0, 0, 0, 0, 0, 0, 0, 0
  0, 0, 0, 0, 0, 0, 0, 0, 0, 0, 0
