---
name: "Whatever works!"
width: 16
height: 16
tilemap: |
  0, 0, 0, 0, 0, 0, 0, 0, 0, 0, 0, 0, 0, 0, 0, 0
  0, 0, 8, 0, 0, 0, 0, 0, 8, 0, 8, 0, 0, 0, 1, 8
  0, 0, 0, 0, 0, 0, 8, 0, 0, 0, 8, 0, 0, 0, 8, 1
  2, 2, 0, 0, 0, 2, 0, 0, 2, 2, 2, 2, 2, 2, 2, 2
  0, 0, 2, 0, 0, 2, 6, 2, 0, 0, 0, 0, 4, 0, 0, 0
  0, 0, 2, 0, 0, 2, 0, 2, 0, 0, 0, 0, 4, 0, 0, 0
  0, 0, 2, 0, 0, 2, 6, 2, 6, 4, 4, 4, 0, 0, 0, 0
  0, 0, 0, 0, 0, 0, 0, 0, 0, 0, 0, 0, 0, 0, 0, 0
  0, 0, 0, 0, 0, 0, 0, 0, 0, 0, 0, 0, 0, 0, 0, 0
  0, 0, 0, 0, 0, 0, 0, 0, 0, 0, 0, 0, 0, 0, 0, 0
  0, 0, 0, 0, 0, 0, 0, 0, 0, 0, 0, 0, 0, 0, 0, 0
  0, 0, 0, 0, 0, 0, 0, 0, 0, 0, 0, 0, 0, 0, 0, 0
  0, 0, 0, 0, 0, 0, 0, 0, 0, 0, 0, 0, 0, 0, 0, 0
  0, 0, 0, 0, 0, 0, 0, 0, 0, 0, 0, 0, 0, 0, 0, 0
  0, 0, 9, 0, 0, 0, 0, 0, 0, 0, 0, 0, 0, 0, 0, 0
  0, 0, 0, 0, 0, 0, 0, 0, 0, 0, 0, 0, 0, 0, 0, 0
objects:
  - kind: crate_player
    x: 4
    z: 9