---
name: "Whatever works reloaded!"
width: 16
height: 16
tilemap: |
  0, 0, 0, 0, 0, 0, 0, 0, 0, 0, 0, 0, 0, 0, 0, 0
  0, 0, 0, 0, 0, 0, 0, 0, 0, 0, 0, 0, 0, 0, 0, 0
  0, 0, 0, 0, 0, 0, 0, 0, 0, 0, 0, 0, 0, 0, 0, 0
  0, 0, 9, 0, 0, 0, 0, 0, 0, 0, 0, 0, 0, 0, 0, 0
  0, 0, 0, 0, 0, 0, 0, 0, 0, 0, 0, 0, 0, 0, 0, 0
  0, 0, 0, 0, 8, 0, 0, 0, 0, 0, 0, 0, 8, 0, 0, 0
  0, 0, 8, 0, 0, 0, 0, 0, 0, 0, 0, 0, 0, 0, 0, 8
  0, 0, 0, 0, 0, 0, 0, 0, 0, 8, 0, 0, 0, 0, 0, 1
  2, 2, 0, 0, 0, 2, 0, 0, 2, 2, 2, 2, 2, 2, 2, 2
  0, 0, 2, 0, 0, 2, 6, 2, 0, 0, 0, 0, 4, 0, 0, 0
  0, 0, 2, 0, 0, 2, 0, 2, 0, 0, 6, 0, 4, 0, 0, 0
  0, 0, 2, 0, 0, 2, 6, 2, 0, 0, 0, 0, 4, 0, 0, 0
  0, 0, 0, 0, 0, 0, 0, 2, 4, 4, 4, 4, 0, 0, 0, 0
  0, 0, 0, 0, 0, 0, 0, 0, 0, 0, 0, 0, 0, 0, 0, 0
  0, 0, 0, 0, 0, 0, 0, 0, 0, 0, 0, 0, 0, 0, 0, 0
  0, 0, 0, 0, 0, 0, 0, 0, 0, 0, 0, 0, 0, 0, 0, 0
objects:
  - kind: crate_player
    x: 4
    z: 9