---
name: "Four seasons landscaping"
width: 15
height: 15
score_perfect: 170
score_perfect_hard: 169
score_okay: 157
tilemap: |
  0, 0, 0, 0, 0, 0, 0, 0, 0, 0, 0, 0, 0, 0, 0
  0, 0, 0, 0, 0, 0, 0, 0, 0, 0, 0, 0, 0, 0, 0
  0, 0, 2, 2, 2, 2, 0, 2, 2, 0, 2, 2, 2, 0, 0
  0, 0, 2, 0, 0, 8, 0, 2, 0, 0, 0, 9, 2, 0, 0
  0, 0, 2, 0, 8, 0, 0, 2, 0, 0, 0, 0, 0, 0, 0
  0, 0, 2, 0, 0, 0, 0, 2,11, 0, 0, 0, 2, 0, 0
  0, 0, 0, 0, 0, 8, 0, 2,11, 0, 0, 0, 2, 0, 0
  0, 0, 2, 2, 2, 2, 2, 2, 2, 2, 2, 2, 2, 0, 0
  0, 0, 0, 0, 0,10,10, 2, 0, 0, 0, 0, 2, 0, 0
  0, 0, 2, 0, 0,10,10, 2, 0, 0, 7, 7, 2, 0, 0
  0, 0, 2, 0, 0, 0, 0, 2, 0, 0, 0, 7, 0, 0, 0
  0, 0, 2, 0, 0, 0, 0, 2, 0, 0, 0, 0, 2, 0, 0
  0, 0, 2, 2, 2, 2, 0, 2, 2, 0, 2, 2, 2, 0, 0
  0, 0, 0, 0, 0, 0, 0, 0, 0, 0, 0, 0, 0, 0, 0
  0, 0, 0, 0, 0, 0, 0, 0, 0, 0, 0, 0, 0, 0, 0
objects:
  - kind: crate_player
    x: 9
    z: 2