---
name: "Catching monsters"
width: 8
height: 8
tilemap: |
  0, 0, 0, 0, 0, 0, 0, 0
  0, 0, 0, 0, 0, 0, 0, 0
  2, 2, 2, 0, 0, 0, 0, 0
  0, 0, 2, 0, 0, 0, 0, 0
  8, 0, 0, 0, 1, 0, 9, 0
  0, 0, 2, 0, 0, 0, 0, 0
  2, 2, 2, 0, 0, 0, 0, 0
  0, 0, 0, 0, 0, 0, 0, 0