---
name: "Activating barriers"
width: 8
height: 8
tilemap: |
  0, 0, 0, 0, 0, 0, 0, 0
  0, 0, 0, 0, 0, 0, 0, 0
  2, 2, 2, 0, 1, 0, 0, 0
  0, 0, 2, 0, 0, 0, 0, 0
  8, 0, 4, 0, 6, 0, 9, 0
  0, 0, 2, 0, 0, 0, 0, 0
  2, 4, 2, 0, 0, 0, 0, 0
  0, 0, 0, 0, 0, 0, 0, 0