---
name: "Freezing monsters"
width: 15
height: 10
score_perfect: 140
tilemap: |
  0, 0, 0, 0, 0, 0, 0, 0, 0, 0, 0, 0, 0, 0, 0
  0, 0, 0, 0, 0, 1, 0, 0, 0, 0, 0, 0, 0, 0, 0
  0, 0, 0, 0, 0, 1, 0, 0,10,10,10,10,10,10, 0
  0, 0, 0, 0, 0, 1, 0, 0,10,10,10,10,10,10, 0
  0, 0, 9, 0, 0, 1, 0, 0,10,10, 0, 8,10,10, 0
  0, 0, 0, 0, 0, 1, 0, 0,10,10, 7, 0,10,10, 0
  0, 0, 0, 0, 0, 1, 0, 0,10,10,10,10,10,10, 0
  0, 0, 0, 0, 0, 1, 0, 0,10,10,10,10,10,10, 0
  0, 0, 0, 0, 0, 1, 0, 0, 0, 0, 0, 0, 0, 0, 0
  0, 0, 0, 0, 0, 0, 0, 0, 0, 0, 0, 0, 0, 0, 0